111111111111
1E0000000001
1C0000110001
1P0000111001
100001000101
100001000101
100001000101
100001000101
111111111111
