11111111111
10000000001
10P00000001
10000000001
10000000001
10000000001
10000000001
10000000001
10000000001
10000000001
100E0000001
10000000001
10000000011
100000001C1
11111111111