1111111111111111111111
1000000000000000000001
1000000000000000000001
1000000000000000000001
100000000000000D000001
100000000000000m000001
100000000000000m000001
10000000000000mm000001
10000000000000m0000001
10000000000000m0000001
1000000000000mm0000001
10000000M0000m00000001
10000000m0000m00000001
10000000m0000m00000001
10000000mmmmmmmmI00001
10000000mP000000000001
10000000m0000000000001
10000000mmmmT000000001
100000000m000000000001
100000000m000000000001
10000000mm000000000001
10000000m0000000000001
10000000m0000000000001
10000tmmmmmmmF00000001
1000000000000000000001
1000000000000000000001
1000000000000000000001
1000000000000000000011
10000000000000000001C1
1111111111111111111111